222222222222222222222222222222222222222222222222222222222222222222222222222222222222222222222222222222222222222222222222
200000000000000000000000000000000000000000000000000000000000100000000000000000000000000000000000000000000000000000000002
200000000000000000000000000000000000000000000000000000000000100000000000000000000000000000000000000000000000000000000002
200000000000000000000000000000000000000000000000000000000000100000000000000000000000000000000000000000000000000000000002
200000000000000000000000000000000000000000000000000000000000100000000000000000000000000000000000000000000000000000000002
200000000000000000000000000000000000000000000000000000000000100000000000000000000000000000000000000000000000000000000002
200000000000000000000000000000000000000000000000000000000000100000000000000000000000000000000000000000000000000000000002
200000000000000000000000000000000000000000000000000000000000100000000000000000000000000000000000000000000000000000000002
200000000000000000000000000000000000000000000000000000000000000000000000000000000000000000000000000000000000000000000002
200000000000000000000000000000000000000000000000000000000000000000000000000000000000000000000000000000000000000000000002
200000000000000000000000000000000000000000000000000000000000000000000000000000000000000000000000000000000000000000000002
200000000000000000000000000000000000000000000000000000000000000000000000000000000000000000000000000000000000000000000002
200000000000000000000000000000000000000000000000000000000000000000000000000000000000000000000000000000000000000000000002
211111111111000000000000000000000000000000000000000000000000000000000000000000000000000000000000000000000000111111111112
200000000000000000000000000000000000000000000000000000000000000000000000000000000000000000000000000000000000000000000002
200000000000000000000000000000000000000000000000000000000000000000000000000000000000000000000000000000000000000000000002
200000000000000000000000000000000000000000000000000000000000000000000000000000000000000000000000000000000000000000000002
200000000000000000000000000000000000000000000000000000000000000000000000000000000000000000000000000000000000000000000002
200000000000000000000000000000000000000000000000000000000000000000000000000000000000000000000000000000000000000000000002
200000000000000000000000000000000000000000000000000000000000000000000000000000000000000000000000000000000000000000000002
200000000000000000000000000000000000000000000000000000000000000000000000000000000000000000000000000000000000000000000002
200000000000000000000000000000000000000000000000000000000000000000000000000000000000000000000000000000000000000000000002
200000000000000000000000000000000000000000000000000000000000100000000000000000000000000000000000000000000000000000000002
200000000000000000000000000000000000000000000000000000000000100000000000000000000000000000000000000000000000000000000002
200000000000000000000000000000000000000000000000000000000000100000000000000000000000000000000000000000000000000000000002
200000000000000000000000000000000000000000000000000000000000100000000000000000000000000000000000000000000000000000000002
200000000000000000000000000000000000000000000000000000000000100000000000000000000000000000000000000000000000000000000002
200000000000000000000000000000000000000000000000000000000000100000000000000000000000000000000000000000000000000000000002
200000000000000000000000000000000000000000000000000000000000100000000000000000000000000000000000000000000000000000000002
222222222222222222222222222222222222222222222222222222222222222222222222222222222222222222222222222222222222222222222222